11111111111111111111111111111111 
10000000000000011000000000000001 
11101010011101111110101001110111
10100011110000011010001111000001 
10001110000111011000111000011101  
00011000110111110001100011011111  
10000010100000001000001010000000  
11111111111111111111111111111111 
10000000000000011111111111111111 
10000000000000011000000000000001 
11101010011101111110101001110111
10100011110000011010001111000001 
10001110000111011000111000011101 
00011000110111110001100011011111 
10000010100000001000001010000000 


