1111111111111111 
1000000000000001 
1110101001110111
1010001111000001 
1000111000011101 
0001100011011111 
1000001010000000 
1111111111111111 
