1111111111111111 
0000000000000001 
1010101001110111
1010001110000101 
1000111000010101 
1001100011011101 
1000001010000001 
1111111110111111