1111111111111111 
1000000000000001 
1010101001110111
1010001110000101 
0010111000010100 
1001100011011101 
1010001010000001 
1111111111111111