1111111111111111 
1000000010000001 
0010101011110111
1010001110000101 
1010111010010101 
1001100000011101 
1010001010000000 
1111111111111111