11111111111111111111111111111111
10200000000000000000000000000021
10010000000000000000000000000001
10011111100001100111000000000001
10000112000001100111111120000001
10000110000000000000111100000005
10000111100000000000110000000001
10000001120000001111112000000001
10000000000000001111110000000001
10000000000000000011000000000001
00000110000000000011000001120001
00000111111000000011200001100001
10000111111000000011000001100001
10000000002000000000000000000201
10000000000000000000000000000001
11111111111111111111111111111111
