11111111111111111111111111111111
10000002000301100000001100000021
10000000000001100000000000000001
10011110000001100111200003011001
10002112000001100111111120000001
10000110000001100000000000000001
10000111100000000000000000000001
10000001120000001111112011110001
10000000000000001111110011112001
10000000000000030011000011000001
00000110000000000011000110000001
00000111111000000011200110000005
10000111111000000011001100300005
10000000032000000000000000000201
12000000000000000000000000000001
11111111111111111111111111111111
