11111111111111111111111111111111
10000002000000000000000000000021
10000000000000000000000000000001
10011111100001100111000003000001
10000112000001100111111120000000
10000110000000000000111100000000
10000111100000000000110000000001
10000001120000001111112000000001
10000000000000001111110000000001
10000000000000000011000000000001
00000110000000000011000000000001
00000111111000000011200000000001
10000111111000000011000000300001
10000000002000000000000000000201
10000000000000000000000000000001
11111111111111111111111111111111
