1111111111111111 
1000000000000000 
1010000001110111
1010001110000001 
1000111000010101 
0001100011011111 
1000001010000001 
1111111111111111 

