11111111111111111111111111111111
10300020000000000000000000000001
10000000000110200000002000000301
10011001130110000110011001100001
10000001100000001100000001111021
10000020000000011100000001111001
10011000000000000000112001100001
10011001100110204000110000000005
10000000000000111100112000000005
00000020000000003000000001100001
00011001100110011000000001111021
10011001100110211000000001111001
10000000000000000001102000000301
10300002000000030001100000000001
10000000000000000000000000000001
11111111111111111111111111111111
