11111111111111111111111111111111
10300020000000002000000040000005
10000000000110200000002000000305
10211001130114000110011001120001
10000001100000001100000201111021
12000000200000011120000001111001
10011000000000000000112001100001
10011001100110204000110000200001
10000000000000111100112000000001
00000020000000003000000001100001
00211001100110011200000001111021
10011201100110211000000001111001
10000000000004000001102040000301
12300002000000000001100000002001
11111111111111111111111111111111